[
[00,00,00,00,00,00,00,00,00,00,00,00,00,00,00,00,00,00,00,00,00,00,00,00,00,00,00,00,00,00,00,00,00,00,00,00,00,00,00,00,00,00,00,00,00,00,00,00,00,00,00,00,00,00,00,00,00,00,00,00,00,00,00,00,00,00,00,00,00,00,00,00,00,00,00,00,00,00,00,00,00,00,00,00,00,00,00,00,00,00,00,00,00,00,00,00,00,00,00,00,00,00,00,00,00,00,00,00,00,00,00,00,00,00,00,00,00,00,00,00,00,00,00,00,00,00,00,00,00,00,00,00,00,00,00,00,00,00,00,00,00,00,00,00,00,00,00,00,00,00,00,00,00,00,00,00,00,00,00,00,00,00,00,00,00,00,00,00,00,00,00,00,00,00,00,00,00,00,00,00,00,00,00,00,00,00,00,00,00,00,00,00,00,00,00,00,00,00,00,00,00,00,00,00,00,00,00,00,00,00,00,00,00,00,00,00,00,00,00,00,00,00,00,00,00,00,00,00,00,00,00,00,00,00,00,00,00,00,00,00,00,00,00,00,00,00,00,00,00,00,00,00,00,00,00,00,00,00,00,00,00,00,00,00,00,00,00,00,00,00,00,00,00,00,00,00,00,00,00,00,00,00,00,00,00,00,00,00,00,00,00,00,00,00,00,00,00,00,00,00,00,00,00,00,00,00,00,00,00,00,00,00,00,00,00,00,00,00,00,00,00,00,00,00,00,00,00,00,00,00,00,00,00,00,00,00,00,00,00,00,00,00,00,00,00,00,00,00,00,00,00,00,00,00,00,00,00,00,00,00,00,00,00,00,00,00,00,00,00,00,00,00,00,00,00,00,00,00,00,00,00,00,00,00,00,00,00,00,00,00,00,00,00,00,00,00,00,00,00,00,00,00,00,00,00,00,00,00,00,00,00,00,00,00,00,00,00,00,00,00,00,00,00,00,00,00,00,00,00,00,00,00,00,00,00,00,00,00,00,00,00,00,00,00,00,00,00,00,00,00,00,00,00,00,00,00,00,00,00,00,00,00,00,00,00,00,00,00,00,00,00,00,00,00,00,00,00,00,00,00,00,00,00,00,00,00,00,00,00,00,00,00,00,00,00,00,00,00,00,00,00,00,00,00,00,00,00,00,00,00,00,00,00,00,00,00,00,00,00,00,00,00,00,00,00,00,00,00,00,00,00,00,00,00,00,00,00,00,00,00,00,00,00,00,00,00,00,00,00,00,00,00,00,00,00,00,00,00,00,00,00,00,00,00,00,00,00,00,00,00,00,00,00,00,00,00,00,00,00,00,00,00,00,00,00,00,00,00,00,00,00,00,00,00,00,00,00,00,00,00,00,00,00,00,00,00,00,00,00,00,00,00,00,00,00,00,00,00,00,00,00,00,00,00,00,00,00,00,00,00,00,00,00,00,00,00,00,00,00,00,00,00,00,00,00,00,00,00,00,00,00,00,00,00,00,00,00,00,00,00,00,00,00,00,00,00,00,00,00,00,00,00,00,00,00,00,00,00,00,00,00,00,00,00,00,00,00,00,00,00,00,00,00,00,00,00,00,00,00,00,00,00,00,00,00,00,00,00,00,00,00,00,00,00,00,00,00,00,00,00,00,00,00,00,00,00,00,00,00,00,00,00,00,00,00,00,00,00,00,00,00,00,00,00,00,00,00,00,00,00,00,00,00,00,00,00,00,00,00,00,00,00,00,00,00,00,00,00,00,00,00,00,00,00,00,00,00,00,00,00,00,00,00,00,00,00,00,00,00,00,00,00,00,00,00,00,00,00,00,00,00,00,00,00,00,00,00,00,00,00,00,00,00,00,00,00,00,00,00,00,00,00,00,00,00,00,00,00,00,00,00,00,00,00,00,00,00,00,00,00,00,00,00,00,00,00,00,00,00,00,00,00,00,00,00,00,00,00,00,00,00,00,00,00,00,00,00,00,00,00,00,00,00,00,00,00,00,00,00,00,00,00,00,00,00,00,00,00,00,00,00,00,00,00,00,00,00,00,00,00,00,00,00,00,00,00,00,00,00,00,00,00,00,00,00,00,00,00,00,00,00,00,00,00,00,00,00,00,00,00,00,00,00,00,00,00,00,00,00,00,00,00,00,00,00,00,00,00,00,00,00,00,00,00,00,00,00,00,00,00,00,00,00,00,00,00,00,00,00,00,00,00,00,00,00,00,00,00,00,00,00,00,00,00,00,00,00,00,00,00,00,00,00,00,00,00,00,00,00,00,00,00,00,00,00,00,00,00,00,00,00,00,00,00,00,00,00,00,00,00,00,00,00,00,00,00,00,00,00,00,00,00,00,00,00,00,00,00,00,00,00,00,00,00,00,00,00,00,00,00,00,00,00,00,00,00,00,00,00,00,00,00,00,00,00,00,00,00,00,00,00,00,00,00,00,00,00,00,00,00,00,00,00,00,00,00,00,00,00,00,00,00,00,00,00,00,00,00,00,00,00,00,00,00,00,00,00,00,00,00,00,00,00,00,00,00,00,00,00,00,00,00,00,00,00,00,00,00,00,00,00,00,00,00,00,00,00,00,00,00,00,00,00,00,00,00,00,00,00,00,00,00],
[00,00,00,00,00,00,00,00,00,00,00,00,00,00,00,00,00,00,00,00,00,00,00,00,00,00,00,00,00,00,00,00,00,00,00,00,00,00,00,00,00,00,00,00,00,00,00,00,00,00,00,00,00,00,00,00,00,00,00,00,00,00,00,00,00,00,00,00,00,00,00,00,00,00,00,00,00,00,00,00,00,00,00,00,00,00,00,00,00,00,00,00,00,00,00,00,00,00,00,00,00,00,00,00,00,00,00,00,00,00,00,00,00,00,00,00,00,00,00,00,00,00,00,00,00,00,00,00,00,00,00,00,00,00,00,00,00,00,00,00,00,00,00,00,00,00,00,00,00,00,00,00,00,00,00,00,00,00,00,00,00,00,00,00,00,00,00,00,00,00,00,00,00,00,00,00,00,00,00,00,00,00,00,00,00,00,00,00,00,00,00,00,00,00,00,00,00,00,00,00,00,00,00,00,00,00,00,00,00,00,00,00,00,00,00,00,00,00,00,00,00,00,00,00,00,00,00,00,00,00,00,00,00,00,00,00,00,00,00,00,00,00,00,00,00,00,00,00,00,00,00,00,00,00,00,00,00,00,00,00,00,00,00,00,00,00,00,00,00,00,00,00,00,00,00,00,00,00,00,00,00,00,00,00,00,00,00,00,00,00,00,00,00,00,00,00,00,00,00,00,00,00,00,00,00,00,00,00,00,00,00,00,00,00,00,00,00,00,00,00,00,00,00,00,00,00,00,00,00,00,00,00,00,00,00,00,00,00,00,00,00,00,00,00,00,00,00,00,00,00,00,00,00,00,00,00,00,00,00,00,00,00,00,00,00,00,00,00,00,00,00,00,00,00,00,00,00,00,00,00,00,00,00,00,00,00,00,00,00,00,00,00,00,00,00,00,00,00,00,00,00,00,00,00,00,00,00,00,00,00,00,00,00,00,00,00,00,00,00,00,00,00,00,00,00,00,00,00,00,00,00,00,00,00,00,00,00,00,00,00,00,00,00,00,00,00,00,00,00,00,00,00,00,00,00,00,00,00,00,00,00,00,00,00,00,00,00,00,00,00,00,00,00,00,00,00,00,00,00,00,00,00,00,00,00,00,00,00,00,00,00,00,00,00,00,00,00,00,00,00,00,00,00,00,00,00,00,00,00,00,00,00,00,00,00,00,00,00,00,00,00,00,00,00,00,00,00,00,00,00,00,00,00,00,00,00,00,00,00,00,00,00,00,00,00,00,00,00,00,00,00,00,00,00,00,00,00,00,00,00,00,00,00,00,00,00,00,00,00,00,00,00,00,00,00,00,00,00,00,00,00,00,00,00,00,00,00,00,00,00,00,00,00,00,00,00,00,00,00,00,00,00,00,00,00,00,00,00,00,00,00,00,00,00,00,00,00,00,00,00,00,00,00,00,00,00,00,00,00,00,00,00,00,00,00,00,00,00,00,00,00,00,00,00,00,00,00,00,00,00,00,00,00,00,00,00,00,00,00,00,00,00,00,00,00,00,00,00,00,00,00,00,00,00,00,00,00,00,00,00,00,00,00,00,00,00,00,00,00,00,00,00,00,00,00,00,00,00,00,00,00,00,00,00,00,00,00,00,00,00,00,00,00,00,00,00,00,00,00,00,00,00,00,00,00,00,00,00,00,00,00,00,00,00,00,00,00,00,00,00,00,00,00,00,00,00,00,00,00,00,00,00,00,00,00,00,00,00,00,00,00,00,00,00,00,00,00,00,00,00,00,00,00,00,00,00,00,00,00,00,00,00,00,00,00,00,00,00,00,00,00,00,00,00,00,00,00,00,00,00,00,00,00,00,00,00,00,00,00,00,00,00,00,00,00,00,00,00,00,00,00,00,00,00,00,00,00,00,00,00,00,00,00,00,00,00,00,00,00,00,00,00,00,00,00,00,00,00,00,00,00,00,00,00,00,00,00,00,00,00,00,00,00,00,00,00,00,00,00,00,00,00,00,00,00,00,00,00,00,00,00,00,00,00,00,00,00,00,00,00,00,00,00,00,00,00,00,00,00,00,00,00,00,00,00,00,00,00,00,00,00,00,00,00,00,00,00,00,00,00,00,00,00,00,00,00,00,00,00,00,00,00,00,00,00,00,00,00,00,00,00,00,00,00,00,00,00,00,00,00,00,00,00,00,00,00,00,00,00,00,00,00,00,00,00,00,00,00,00,00,00,00,00,00,00,00,00,00,00,00,00,00,00,00,00,00,00,00,00,00,00,00,00,00,00,00,00,00,00,00,00,00,00,00,00,00,00,00,00,00,00,00,00,00,00,00,00,00,00,00,00,00,00,00,00,00,00,00,00,00,00,00,00,00,00,00,00,00,00,00,00,00,00,00,00,00,00,00,00,00,00,00,00,00,00,00,00,00,00,00,00,00,00,00,00,00,00,00,00,00,00,00,00,00,00,00,00,00,00,00,00,00,00,00,00,00,00,00,00,00,00,00,00,00,00,00,00,00,00,00,00,00,00,00,00,00,00,00,00,00,00,00,00,00,00,00,00,00,00,00,00,00,00,00,00,00,00,00,00,00,00,00,00,00,00,00,00,00,00,00,00,00,00,00,00,00,00,00,00,00,00,00],
[00,00,08,09,10,00,00,00,00,00,00,00,00,00,00,00,00,00,19,00,00,00,00,00,00,00,00,00,00,00,00,00,00,00,00,00,00,00,00,00,00,19,00,00,00,00,00,00,00,00,00,00,00,00,00,00,00,00,00,19,00,00,00,00,00,00,19,00,00,00,00,00,00,00,00,00,00,00,00,00,00,19,00,00,00,00,00,00,00,19,00,00,00,00,00,00,00,00,00,00,00,00,00,00,00,00,00,00,00,00,00,00,00,00,19,00,00,00,00,00,00,00,00,00,00,00,00,00,00,00,00,00,00,00,00,00,00,00,19,00,00,00,00,00,00,00,00,00,00,00,00,00,00,00,19,00,00,00,00,00,00,00,00,19,00,00,00,00,00,00,00,00,00,00,00,19,00,00,00,00,00,00,00,00,00,00,19,00,00,00,00,00,00,00,00,00,00,00,00,00,00,00,00,00,00,00,00,00,00,00,00,19,00,00,00,00,00,00,00,00,00,00,00,19,00,00,00,00,00,00,00,00,00,00,19,00,00,00,00,00,00,00,00,00,00,00,00,00,00,19,00,00,00,00,00,00,00,00,00,19,00,00,00,00,00,00,00,00,00,00,00,19,00,00,00,00,00,00,00,00,00,00,19,00,00,00,00,00,00,00,00,00,00,00,00,00,00,19,00,00,00,00,00,00,00,00,00,19,00,00,00,00,00,00,00,00,00,00,00,19,00,00,00,00,00,00,00,00,00,00,19,00,00,00,00,00,00,00,00,00,00,00,00,00,00,19,00,00,00,00,00,00,00,00,00,19,00,00,00,00,00,00,00,00,00,00,00,19,00,00,00,00,00,00,00,00,00,00,19,00,00,00,00,19,00,00,00,00,00,00,00,00,00,19,00,00,00,00,00,00,00,00,00,19,00,00,00,00,00,00,00,00,00,00,00,19,00,00,00,00,00,00,00,00,00,00,19,00,00,00,00,00,00,00,00,00,00,00,00,00,00,19,00,00,00,00,00,00,00,00,00,19,00,00,00,00,00,00,00,00,00,00,00,19,00,00,00,00,00,00,00,00,00,00,00,00,00,00,00,00,00,00,00,00,00,00,00,00,00,19,00,00,00,00,00,00,00,00,00,00,00,00,00,00,00,00,00,00,00,00,00,19,00,00,00,00,00,00,00,00,00,00,00,00,19,00,00,00,00,00,00,00,00,00,00,00,00,19,00,00,00,00,00,00,00,00,00,00,00,19,00,00,00,00,00,00,00,00,00,19,00,00,00,00,00,00,00,00,00,00,00,00,00,00,00,00,19,00,00,00,00,19,00,00,00,00,00,00,00,19,00,00,00,00,00,00,00,00,00,00,00,00,00,00,00,00,00,19,00,00,00,00,00,00,00,00,00,00,00,00,19,00,00,00,00,00,00,00,00,00,00,00,00,19,00,00,00,00,00,00,00,00,00,00,00,19,00,00,00,00,00,00,00,00,00,19,00,00,00,00,00,00,00,00,00,00,00,00,00,00,00,00,00,00,00,00,00,00,00,00,00,19,00,00,00,00,00,00,00,00,00,00,00,00,00,00,00,00,00,00,00,00,00,19,00,00,00,00,00,00,00,00,00,00,19,00,00,00,00,00,00,00,00,00,00,00,00,00,00,19,00,00,00,00,00,00,00,00,00,19,00,00,00,00,00,00,00,00,00,00,00,19,00,00,00,00,00,00,00,00,00,00,19,00,00,00,00,19,00,00,00,00,00,00,00,00,00,19,00,00,00,00,00,00,00,00,00,19,00,00,00,00,00,00,00,00,00,00,00,19,00,00,00,00,00,00,00,00,00,00,19,00,00,00,00,00,00,00,00,00,00,00,00,00,00,19,00,00,00,00,00,00,00,00,00,19,00,00,00,00,00,00,00,00,00,00,00,19,00,00,00,00,00,00,00,00,00,00,19,00,00,00,00,00,00,00,00,00,00,00,00,00,00,19,00,00,00,00,00,00,00,00,00,19,00,00,00,00,00,00,00,00,00,00,00,19,00,00,00,00,00,00,00,00,00,00,19,00,00,00,00,00,00,00,00,00,00,00,00,00,00,19,00,00,00,00,00,00,00,00,00,19,00,00,00,00,00,00,00,00,00,00,00,19,00,00,00,00,00,00,00,00,00,00,19,00,00,00,00,00,00,00,00,00,00,00,00,00,00,00,00,00,00,00,00,00,00,00,00,19,00,00,00,00,00,00,00,00,00,00,00,19,00,00,00,00,00,00,00,00,00,00,19,00,00,00,00,00,00,00,00,00,00,00,00,00,00,00,00,19,00,00,00,00,00,00,00,19,00,00,00,00,00,00,00,00,00,00,00,00,00,00,00,00,00,00,00,00,00,00,19,00,00,00,00,00,00,00,00,00,00,00,00,00,00,00,00,00,00,00,00,00,00,00,00,19,00,00,00,00,00,00,00,00,00,00,00,00,19,00,00,00,00,00,00,00,00,00,19,00,00,00,00,00,00,00,00,00,00,00,00,00,00,00,00,19,00,00,00,00,00,00,00,19,00,00,00,00,00,00,00,00,00,00,00,00,00,00,00,00,00,00,00,00,00,00,00,11,12,13,00,00],
[01,01,28,29,30,01,01,01,02,14,01,18,02,01,17,01,01,14,01,05,05,01,01,17,01,18,01,01,01,14,01,01,01,02,01,01,01,18,01,01,14,01,16,16,01,01,01,17,15,01,01,01,01,01,01,01,01,02,01,01,18,01,01,17,01,14,01,16,16,01,01,17,17,18,01,01,01,14,01,02,15,01,01,01,01,18,01,14,01,01,05,05,01,01,17,01,01,15,01,01,01,01,01,01,01,14,02,01,18,01,01,01,17,14,01,05,05,01,17,01,01,18,17,01,01,14,02,01,01,15,02,01,01,18,01,14,01,01,16,16,01,17,01,01,01,01,15,01,01,01,01,01,01,02,14,01,18,01,01,01,01,17,14,16,16,17,01,01,01,18,01,17,14,02,01,05,05,15,01,02,01,18,01,14,01,01,05,05,17,01,01,01,01,01,01,15,01,01,01,01,02,14,01,01,02,01,01,01,01,01,17,05,05,01,01,01,01,18,01,01,02,17,14,16,16,01,01,15,02,18,01,01,14,01,16,16,17,01,01,01,01,01,01,01,15,01,01,02,01,05,05,01,18,02,01,01,01,01,17,16,16,01,01,01,01,18,01,02,01,17,14,05,05,01,01,15,01,02,01,01,14,01,05,05,01,01,01,01,01,01,01,01,01,15,02,01,01,16,16,01,18,01,02,01,01,17,14,05,05,01,01,01,01,18,02,01,01,01,17,16,16,01,01,15,01,18,02,01,14,01,16,16,01,01,01,01,01,01,01,01,01,02,15,01,01,05,05,01,18,01,01,02,17,01,14,16,16,01,01,01,01,02,01,01,01,01,14,05,05,01,01,01,01,18,01,02,01,14,05,05,01,01,01,02,01,01,15,01,02,01,01,01,01,16,16,01,18,01,01,17,02,01,14,05,05,17,01,01,02,18,01,01,01,14,01,16,16,01,01,01,15,18,01,14,02,17,16,16,01,01,02,01,01,01,01,02,01,01,01,01,01,05,05,01,18,01,17,01,01,02,14,16,16,01,17,02,01,18,01,01,01,14,01,05,05,17,01,01,01,18,01,14,17,02,01,01,01,02,01,01,01,01,02,01,01,01,01,01,01,16,16,01,18,17,01,01,01,14,02,01,01,01,02,17,01,18,01,01,01,01,14,16,16,01,17,01,01,18,15,01,17,01,02,01,01,01,01,01,01,02,01,01,01,01,01,01,01,05,05,01,18,01,01,01,01,01,01,02,14,01,01,01,17,18,01,01,01,14,01,05,05,01,01,17,01,18,01,01,17,01,01,02,01,01,01,01,01,01,01,01,01,16,16,01,01,14,15,17,18,05,05,01,01,14,01,01,02,01,01,01,17,18,01,01,14,01,01,16,16,01,01,17,01,18,01,17,01,01,02,01,01,01,01,01,01,02,01,01,01,01,01,01,01,05,05,15,18,01,01,01,01,01,01,02,01,01,01,01,01,18,01,01,01,01,01,05,05,01,01,01,17,18,01,17,01,02,15,01,01,02,01,01,01,01,02,01,01,01,01,01,01,16,16,15,18,01,01,01,01,01,02,14,01,01,02,01,01,18,17,01,01,14,01,16,16,01,01,01,01,18,01,17,02,01,16,16,01,01,02,01,01,01,01,02,01,01,01,01,17,05,05,01,18,01,01,01,01,02,14,05,05,01,01,02,01,18,17,01,01,14,01,05,05,01,01,01,01,18,17,02,14,01,05,05,15,01,01,02,01,01,01,01,02,01,01,17,01,16,16,01,18,01,01,01,02,01,14,16,16,01,01,01,02,18,01,17,01,14,01,16,16,01,01,01,01,18,02,01,14,01,16,15,01,01,01,01,01,01,01,01,01,02,17,01,01,05,05,01,18,15,01,02,01,01,14,05,05,01,01,01,01,02,01,01,17,14,01,05,05,01,01,01,01,02,17,01,17,01,05,05,01,15,01,01,01,01,01,01,01,17,02,01,01,16,16,01,18,15,02,01,01,01,14,16,16,01,01,01,01,18,02,01,17,01,01,16,16,01,01,01,02,18,01,14,17,01,16,15,01,01,01,01,01,01,01,01,17,01,01,02,01,05,05,01,18,02,15,01,01,01,14,05,05,01,01,01,01,18,01,02,14,17,01,05,05,01,01,02,17,18,01,14,01,01,05,05,01,01,15,01,01,01,01,17,01,01,01,01,02,14,01,01,02,01,01,15,01,01,14,16,16,01,01,01,01,18,01,01,02,14,01,16,16,01,02,01,17,18,01,14,01,01,16,16,01,01,15,01,01,01,17,01,01,01,01,01,01,02,01,01,18,01,01,15,01,01,14,05,05,01,01,01,01,18,01,01,01,02,14,17,01,02,01,17,01,18,01,14,01,01,05,05,01,01,01,15,01,17,01,01,01,01,01,01,01,14,02,01,18,01,01,01,15,01,14,16,16,01,01,01,01,18,01,01,01,14,02,01,01,01,17,01,01,18,01,14,01,01,16,16,01,01,01,15,17,01,01,01,01,01,01,01,01,02,01,01,18,01,01,01,01,15,14,05,05,01,01,01,01,18,01,01,14,01,01,02,01,17,01,01,01,18,01,01,14,01,01,31,32,33,01,01],
[07,00,00,00,00,00,03,00,00,00,00,00,00,00,00,00,00,00,00,00,00,00,00,07,00,00,00,00,00,00,00,00,00,00,00,00,00,00,00,03,00,00,00,00,00,00,07,00,00,07,00,00,00,00,03,00,00,00,00,00,00,00,00,00,00,00,00,00,00,00,07,03,07,00,00,00,00,00,00,00,00,00,00,00,00,00,03,00,00,00,00,00,00,07,00,00,00,00,07,00,00,00,03,00,00,00,00,00,00,00,00,00,00,00,00,00,00,07,00,03,00,07,00,00,00,00,00,00,00,00,00,00,00,00,03,00,00,00,00,00,07,00,00,00,00,00,00,07,00,00,03,00,00,00,00,00,00,00,00,00,00,00,00,00,07,00,00,03,00,00,07,00,00,00,00,00,00,00,00,00,00,00,03,00,00,00,00,07,00,00,00,00,00,00,00,00,07,00,03,00,00,00,00,00,00,00,00,00,00,00,00,07,00,00,00,03,00,00,00,07,00,00,00,00,00,00,00,00,00,00,03,00,00,00,07,00,00,00,00,00,00,00,00,00,00,07,03,00,00,00,00,00,00,00,00,00,00,00,07,00,00,00,00,03,00,00,00,00,07,00,00,00,00,00,00,00,00,00,03,00,00,07,00,00,00,00,00,00,00,00,00,00,00,00,00,00,00,00,00,00,00,00,00,00,00,07,00,00,00,00,00,00,03,00,00,00,00,07,00,00,00,00,00,00,00,00,00,03,07,00,00,00,00,00,00,00,00,00,00,00,00,00,03,07,00,00,00,00,00,00,00,00,07,00,00,00,00,00,00,03,00,00,00,00,00,00,07,00,00,00,00,00,00,00,00,00,00,00,00,00,00,00,00,00,00,00,00,00,00,00,03,00,07,00,00,00,00,00,00,07,00,00,00,00,00,00,00,03,00,00,00,00,00,00,00,07,00,00,00,00,00,00,07,03,00,00,00,00,00,00,00,00,00,00,00,00,00,00,03,00,00,07,00,00,00,00,07,00,00,00,00,00,00,00,00,00,00,00,00,00,00,00,00,00,07,00,00,00,00,07,00,03,00,00,00,00,00,00,00,00,00,00,00,00,00,00,03,00,00,00,07,00,00,07,00,00,00,00,00,00,00,00,00,03,00,00,00,00,00,00,00,00,00,07,00,00,07,00,00,03,00,00,00,00,00,00,00,00,00,00,00,00,00,00,03,00,00,00,00,07,07,00,00,00,00,00,00,00,00,00,00,03,00,00,00,00,00,00,00,00,00,00,07,07,00,00,00,03,00,00,00,00,00,00,00,00,00,00,00,00,00,00,03,00,00,00,00,07,07,00,00,00,00,00,00,00,00,00,00,03,00,00,00,00,00,00,00,00,00,00,07,07,00,00,00,03,00,00,00,00,00,00,00,00,00,00,00,00,00,00,03,00,00,00,07,00,00,07,00,00,00,00,00,00,00,00,00,03,00,00,00,00,00,00,00,00,00,07,00,00,07,00,00,03,00,00,00,00,00,00,00,00,00,00,00,00,00,00,03,00,00,07,00,00,00,00,07,00,00,00,00,00,00,00,00,03,00,00,00,00,00,00,00,00,07,00,00,00,00,07,00,03,00,00,00,00,00,00,00,00,00,00,00,00,00,00,03,00,07,00,00,00,00,00,00,07,00,00,00,00,00,00,00,00,00,00,00,00,00,22,00,07,00,00,00,00,00,00,07,00,00,00,00,00,00,00,00,00,00,00,00,00,00,00,03,07,00,00,00,00,00,00,00,00,00,00,00,00,00,00,00,03,00,00,00,00,00,00,07,00,00,00,00,00,00,00,00,07,00,00,00,00,00,00,00,00,00,00,00,00,00,00,07,00,00,00,00,00,00,00,00,00,00,07,00,00,00,00,00,03,00,00,00,00,00,07,00,00,00,00,00,00,00,00,00,03,07,00,00,00,00,00,00,00,00,00,00,00,00,07,00,00,00,00,00,00,00,00,00,00,00,00,07,00,00,00,00,03,00,00,00,00,07,00,00,00,00,00,00,00,00,00,00,03,00,07,00,00,00,00,00,00,00,00,00,00,07,00,03,00,00,00,00,00,00,00,00,00,00,00,00,07,00,00,00,03,00,00,00,00,00,00,00,00,00,00,00,00,00,00,03,00,00,00,07,00,00,00,00,00,00,00,00,07,00,00,03,00,00,00,00,00,00,00,00,00,00,00,00,00,07,00,00,03,00,00,07,00,00,00,00,00,00,00,00,00,00,00,03,00,00,00,00,07,00,00,00,00,00,00,07,00,00,00,03,00,00,00,00,00,00,00,00,00,00,00,00,00,00,07,00,03,00,07,00,00,00,00,00,00,00,00,00,00,00,00,03,00,00,00,00,00,07,00,00,00,00,07,00,00,00,00,03,00,00,00,00,00,00,00,00,00,00,00,00,00,00,00,07,03,07,00,00,00,00,00,00,00,00,00,00,00,00,00,03,00,00,00,00,00,00,07,00,00,07,00,00,00,00,00,03,00,00,00,00,00,00,00,00,00,00,00,00,00,00,00,00,07,00,00,00,00,00,00,00,00,00,00,00,00,00,00,03,00,00,00,00,00,00,00,07,00],
[00,00,00,00,00,00,00,00,00,00,00,00,00,00,00,00,00,00,00,00,00,00,00,00,00,00,00,00,00,00,00,00,00,00,00,00,00,00,00,00,00,00,00,00,00,00,00,00,00,00,00,00,00,00,00,00,00,00,00,00,00,00,00,00,00,00,00,00,00,00,00,00,00,00,00,00,00,00,00,00,00,00,00,00,00,00,00,00,00,00,00,00,00,00,00,00,00,00,00,00,00,00,00,00,00,00,00,00,00,00,00,00,00,00,00,00,00,00,00,00,00,00,00,00,00,00,00,00,00,00,00,00,00,00,00,00,00,00,00,00,00,00,00,00,00,00,00,00,00,00,00,00,00,00,00,00,00,00,00,00,00,00,00,00,00,00,00,00,00,00,00,00,00,00,00,00,00,00,00,00,00,00,00,00,00,00,00,00,00,00,00,00,00,00,00,00,00,00,00,00,00,00,00,00,00,00,00,00,00,00,00,00,00,00,00,00,00,00,00,00,00,00,00,00,00,00,00,00,00,00,00,00,00,00,00,00,00,00,00,00,00,00,00,00,00,00,00,00,00,00,00,00,00,00,00,00,00,00,00,00,00,00,00,00,00,00,00,00,00,00,00,00,00,00,00,00,00,00,00,00,00,00,00,00,00,00,00,00,00,00,00,00,00,00,00,00,00,00,00,00,00,00,00,00,00,00,00,00,00,00,00,00,00,00,00,00,00,00,00,00,00,00,00,00,00,00,00,00,00,00,00,00,00,00,00,00,00,00,00,00,00,00,00,00,00,00,00,00,00,00,00,00,00,00,00,00,00,00,00,00,00,00,00,00,00,00,00,00,00,00,00,00,00,00,00,00,00,00,00,00,00,00,00,00,00,00,00,00,00,00,00,00,00,00,00,00,00,00,00,00,00,00,00,00,00,00,00,00,00,00,00,00,00,00,00,00,00,00,00,00,00,00,00,00,00,00,00,00,00,00,00,00,00,00,00,00,00,00,00,00,00,00,00,00,00,00,00,00,00,00,00,00,00,00,00,00,00,00,00,00,00,00,00,00,00,00,00,00,00,00,00,00,00,00,00,00,00,00,00,00,00,00,00,00,00,00,00,00,00,00,00,00,00,00,00,00,00,00,00,00,00,00,00,00,00,00,00,00,00,00,00,00,00,00,00,00,00,00,00,00,00,00,00,00,00,00,00,00,00,00,00,00,00,00,00,00,00,00,00,00,00,00,00,00,00,00,00,00,00,00,00,00,00,00,00,00,00,00,00,00,00,00,00,00,00,00,00,00,00,00,00,00,00,00,00,00,00,00,00,00,00,00,00,00,00,00,00,00,00,00,00,00,00,00,00,00,00,00,00,00,00,00,00,00,00,00,00,00,00,00,00,00,00,00,00,00,00,00,00,00,00,00,00,00,00,00,00,00,00,00,00,00,00,00,00,00,00,00,00,00,00,00,00,00,00,00,00,00,00,00,00,00,00,00,00,00,00,00,00,00,00,00,00,00,00,00,00,00,00,00,00,00,00,00,00,00,00,00,00,00,00,00,00,00,00,00,00,00,00,00,00,00,00,00,00,00,00,00,00,00,00,00,00,00,00,00,00,00,00,00,00,00,00,00,00,00,00,00,00,00,00,00,00,00,00,00,00,00,00,00,00,00,00,00,00,00,00,00,00,00,00,00,00,00,00,00,00,00,00,00,00,00,00,00,00,00,00,00,00,00,00,00,00,00,00,00,00,00,00,00,00,00,00,00,00,00,00,00,00,00,00,00,00,00,00,00,00,00,00,00,00,00,00,00,00,00,00,00,00,00,00,00,00,00,00,00,00,00,00,00,00,00,00,00,00,00,00,00,00,00,00,00,00,00,00,00,00,00,00,00,00,00,00,00,00,00,00,00,00,00,00,00,00,00,00,00,00,00,00,00,00,00,00,00,00,00,00,00,00,00,00,00,00,00,00,00,00,00,00,00,00,00,00,00,00,00,00,00,00,00,00,00,00,00,00,00,00,00,00,00,00,00,00,00,00,00,00,00,00,00,00,00,00,00,00,00,00,00,00,00,00,00,00,00,00,00,00,00,00,00,00,00,00,00,00,00,00,00,00,00,00,00,00,00,00,00,00,00,00,00,00,00,00,00,00,00,00,00,00,00,00,00,00,00,00,00,00,00,00,00,00,00,00,00,00,00,00,00,00,00,00,00,00,00,00,00,00,00,00,00,00,00,00,00,00,00,00,00,00,00,00,00,00,00,00,00,00,00,00,00,00,00,00,00,00,00,00,00,00,00,00,00,00,00,00,00,00,00,00,00,00,00,00,00,00,00,00,00,00,00,00,00,00,00,00,00,00,00,00,00,00,00,00,00,00,00,00,00,00,00,00,00,00,00,00,00,00,00,00,00,00,00,00,00,00,00,00,00,00,00,00,00,00,00,00,00,00,00,00,00,00,00,00,00,00,00,00,00,00,00,00,00,00,00,00,00,00,00,00,00,00,00,00,00,00,00,00,00,00,00,00,00,00,00,00,00,00,00,00,00,00,00,00,00,00,00,00,00,00,00,00,00,00,00,00,00,00,00,00,00,00,00,00,00,00,00,00,00,00,00,00,00],
[00,00,00,00,00,00,00,00,00,00,00,00,00,00,00,00,00,00,00,00,00,00,00,00,00,00,00,00,00,00,00,00,00,00,00,00,00,00,00,00,00,00,00,00,00,00,00,00,00,00,00,00,00,00,00,00,00,00,00,00,00,00,00,00,00,00,00,00,00,00,00,00,00,00,00,00,00,00,00,00,00,00,00,00,00,00,00,00,00,00,00,00,00,00,00,00,00,00,00,00,00,00,00,00,00,00,00,00,00,00,00,00,00,00,00,00,00,00,00,00,00,00,00,00,00,00,00,00,00,00,00,00,00,00,00,00,00,00,00,00,00,00,00,00,00,00,00,00,00,00,00,00,00,00,00,00,00,00,00,00,00,00,00,00,00,00,00,00,00,00,00,00,00,00,00,00,00,00,00,00,00,00,00,00,00,00,00,00,00,00,00,00,00,00,00,00,00,00,00,00,00,00,00,00,00,00,00,00,00,00,00,00,00,00,00,00,00,00,00,00,00,00,00,00,00,00,00,00,00,00,00,00,00,00,00,00,00,00,00,00,00,00,00,00,00,00,00,00,00,00,00,00,00,00,00,00,00,00,00,00,00,00,00,00,00,00,00,00,00,00,00,00,00,00,00,00,00,00,00,00,00,00,00,00,00,00,00,00,00,00,00,00,00,00,00,00,00,00,00,00,00,00,00,00,00,00,00,00,00,00,00,00,00,00,00,00,00,00,00,00,00,00,00,00,00,00,00,00,00,00,00,00,00,00,00,00,00,00,00,00,00,00,00,00,00,00,00,00,00,00,00,00,00,00,00,00,00,00,00,00,00,00,00,00,00,00,00,00,00,00,00,00,00,00,00,00,00,00,00,00,00,00,00,00,00,00,00,00,00,00,00,00,00,00,00,00,00,00,00,00,00,00,00,00,00,00,00,00,00,00,00,00,00,00,00,00,00,00,00,00,00,00,00,00,00,00,00,00,00,00,00,00,00,00,00,00,00,00,00,00,00,00,00,00,00,00,00,00,00,00,00,00,00,00,00,00,00,00,00,00,00,00,00,00,00,00,00,00,00,00,00,00,00,00,00,00,00,00,00,00,00,00,00,00,00,00,00,00,00,00,00,00,00,00,00,00,00,00,00,00,00,00,00,00,00,00,00,00,00,00,00,00,00,00,00,00,00,00,00,00,00,00,00,00,00,00,00,00,00,00,00,00,00,00,00,00,00,00,00,00,00,00,00,00,00,00,00,00,00,00,00,00,00,00,00,00,00,00,00,00,00,00,00,00,00,00,00,00,00,00,00,00,00,00,00,00,00,00,00,00,00,00,00,00,00,00,00,00,00,00,00,00,00,00,00,00,00,00,00,00,00,00,00,00,00,00,00,00,00,00,00,00,00,00,00,00,00,00,00,00,00,00,00,00,00,00,00,00,00,00,00,00,00,00,00,00,00,00,00,00,00,00,00,00,00,00,00,00,00,00,00,00,00,00,00,00,00,00,00,00,00,00,00,00,00,00,00,00,00,00,00,00,00,00,00,00,00,00,00,00,00,00,00,00,00,00,00,00,00,00,00,00,00,00,00,00,00,00,00,00,00,00,00,00,00,00,00,00,00,00,00,00,00,00,00,00,00,00,00,00,00,00,00,00,00,00,00,00,00,00,00,00,00,00,00,00,00,00,00,00,00,00,00,00,00,00,00,00,00,00,00,00,00,00,00,00,00,00,00,00,00,00,00,00,00,00,00,00,00,00,00,00,00,00,00,00,00,00,00,00,00,00,00,00,00,00,00,00,00,00,00,00,00,00,00,00,00,00,00,00,00,00,00,00,00,00,00,00,00,00,00,00,00,00,00,00,00,00,00,00,00,00,00,00,00,00,00,00,00,00,00,00,00,00,00,00,00,00,00,00,00,00,00,00,00,00,00,00,00,00,00,00,00,00,00,00,00,00,00,00,00,00,00,00,00,00,00,00,00,00,00,00,00,00,00,00,00,00,00,00,00,00,00,00,00,00,00,00,00,00,00,00,00,00,00,00,00,00,00,00,00,00,00,00,00,00,00,00,00,00,00,00,00,00,00,00,00,00,00,00,00,00,00,00,00,00,00,00,00,00,00,00,00,00,00,00,00,00,00,00,00,00,00,00,00,00,00,00,00,00,00,00,00,00,00,00,00,00,00,00,00,00,00,00,00,00,00,00,00,00,00,00,00,00,00,00,00,00,00,00,00,00,00,00,00,00,00,00,00,00,00,00,00,00,00,00,00,00,00,00,00,00,00,00,00,00,00,00,00,00,00,00,00,00,00,00,00,00,00,00,00,00,00,00,00,00,00,00,00,00,00,00,00,00,00,00,00,00,00,00,00,00,00,00,00,00,00,00,00,00,00,00,00,00,00,00,00,00,00,00,00,00,00,00,00,00,00,00,00,00,00,00,00,00,00,00,00,00,00,00,00,00,00,00,00,00,00,00,00,00,00,00,00,00,00,00,00,00,00,00,00,00,00,00,00,00,00,00,00,00,00,00,00,00,00,00,00,00,00,00,00,00,00,00,00,00,00,00,00,00,00,00,00,00,00,00,00,00,00,00,00,00,00,00,00,00,00,00,00,00,00,00]
] 
